[console_scripts]
check-column-desc-are-same = dbt_gloss.check_column_desc_are_same:main
check-column-name-contract = dbt_gloss.check_column_name_contract:main
check-macro-arguments-have-desc = dbt_gloss.check_macro_arguments_have_desc:main
check-macro-has-description = dbt_gloss.check_macro_has_description:main
check-model-columns-have-desc = dbt_gloss.check_model_columns_have_desc:main
check-model-has-all-columns = dbt_gloss.check_model_has_all_columns:main
check-model-has-description = dbt_gloss.check_model_has_description:main
check-model-has-meta-keys = dbt_gloss.check_model_has_meta_keys:main
check-model-has-properties-file = dbt_gloss.check_model_has_properties_file:main
check-model-has-tests = dbt_gloss.check_model_has_tests:main
check-model-has-tests-by-group = dbt_gloss.check_model_has_tests_by_group:main
check-model-has-tests-by-name = dbt_gloss.check_model_has_tests_by_name:main
check-model-has-tests-by-type = dbt_gloss.check_model_has_tests_by_type:main
check-model-name-contract = dbt_gloss.check_model_name_contract:main
check-model-parents-and-childs = dbt_gloss.check_model_parents_and_childs:main
check-model-parents-database = dbt_gloss.check_model_parents_database:main
check-model-parents-schema = dbt_gloss.check_model_parents_schema:main
check-model-tags = dbt_gloss.check_model_tags:main
check-script-has-no-table-name = dbt_gloss.check_script_has_no_table_name:main
check-script-ref-and-source = dbt_gloss.check_script_ref_and_source:main
check-script-semicolon = dbt_gloss.check_script_semicolon:main
check-source-childs = dbt_gloss.check_source_childs:main
check-source-columns-have-desc = dbt_gloss.check_source_columns_have_desc:main
check-source-has-all-columns = dbt_gloss.check_source_has_all_columns:main
check-source-has-freshness = dbt_gloss.check_source_has_freshness:main
check-source-has-loader = dbt_gloss.check_source_has_loader:main
check-source-has-meta-keys = dbt_gloss.check_source_has_meta_keys:main
check-source-has-tests = dbt_gloss.check_source_has_tests:main
check-source-has-tests-by-name = dbt_gloss.check_source_has_tests_by_name:main
check-source-has-tests-by-type = dbt_gloss.check_source_has_tests_by_type:main
check-source-table-has-description = dbt_gloss.check_source_table_has_description:main
check-source-tags = dbt_gloss.check_source_tags:main
dbt-clean = dbt_gloss.dbt_clean:main
dbt-compile = dbt_gloss.dbt_compile:main
dbt-deps = dbt_gloss.dbt_deps:main
dbt-docs-generate = dbt_gloss.dbt_docs_generate:main
dbt-run = dbt_gloss.dbt_run:main
dbt-test = dbt_gloss.dbt_test:main
generate-missing-sources = dbt_gloss.generate_missing_sources:main
generate-model-properties-file = dbt_gloss.generate_model_properties_file:main
remove-script-semicolon = dbt_gloss.remove_script_semicolon:main
replace-script-table-names = dbt_gloss.replace_script_table_names:main
unify-column-description = dbt_gloss.unify_column_description:main

